The article: bài báo
Address (v): chỉ ra    &&  (n): bài diễn văn trang trọng
Avoid: tránh
Demonstrate: chứng minh, minh họa
Develop: phát triển
Evaluate: đánh giá
Gather: tập trung
Offer: cung cấp
Primarily: chủ yếu
Risk: rủi ro
Strategy: chiến lược
Strong: mạnh
Substitution = replacement: sự thay thế

Accommodate: đáp ứng
Make Arrangement: sự xắp xếp
Get in touch with: liên lạc với
Hold: chứa, tổ chức, nắm giữ
Register: đăng ký
Select: chọn
Session: phiên họp
Take part in: tham gia vào

Failure: thất bại, lỗi
Failure to V1: không chịu làm gì
Ignore: phớt lờ

Affordable: có khả năng chi trả
Be in charge of: phụ trách
Capacity: sức chứa, khả năng
Stock: (v) tích trữ, (n) hàng hóa

Appreciation: sự cảm kích
Expose: phơi bày ra
Outdated: lỗi thời
Practice: sự hoạt động

Popularity: sự phổ biến
Correspondence: thư tín
Assemble: tập hợp
In advance: trước - (ex: 10 year in advance: 10 năm trước)
Complication: sự phức tạp
Courier: người đưa thư
Express: tốc hành
Fold: xếp lại, gấp lại
Layout: bố cục
Mention: đề cập
Petition: lá đơn
Proof (n): tìm lỗi sai  
Evidence: chứng cứ
Register: đăng ký
Revise: duyệt lại
Envelope: bao thư
Recipient: người nhận
Appropriately: 1 cách thích hợp

Accomplish (v) = achieve: đạt được
Abundant: dồi dào, phong phú
Accomplishment = achivevement: thành tựu
Bring together: tập hợp
Candidate: ứng cử viên
Come up with: đưa ra
Commensurate with: tương xứng với
Match: phù hợp
Profile: tiểu xử, sơ lượt
Qualifications: chất lượng
Recuit: tuyển dụng
Submit: nộp
Time-consuming: tốn thời gian

Ability: khả năg
Apply: nộp
Background: lí lịch
Be ready for: sẵng sàng
Call in: gọi vào
Confidence: sự tự tin
Constantly: liên lạc
Expert: chuyên gia
Follow up: theo sau
Hesitant: do dự
Present: trình bày, xuất trình
Weakly: 1 cách yếu ớt

Hire: thuê, mướn
Keep up with: bắt kịp
On schedule: theo đúng lịch trình
Reject: từ chối
Success: thành công
Training: huấn luyện
Update: cập nhật
Please extend my thank to him: vui lòng gửi lời cảm ơn của tôi đến anh ta
Please convey my thank to him: vui lòng gửi lời cảm ơn của tôi đến anh ta

Salaries: lương
Benefits: lợi ích
Basic: nguyên tác, nền tảng
Be aware of: nhận thức về
Compensate: bồi thường
Delicately: tế nhị
Eligible: đủ điều kiện, đủ tư cách
Flexibly: linh hoạt
Negotiate: thương lượng
Raise: mức tăng lương
Retire: về hưu
Vested: đảm bảo
Wage: lương, tiền công
Adequately: 1 cách đầy đủ
Review(n): đợt cân nhắc tăng lương
Unique: đặc biệt, độc đáo, độc nhất

Pension plan: kế hoạch trả lương hưu
Awards: tận hưởng
Dedication: sự cống hiến
Look forward to + V_ing: trông mong
Loyal: trung thành
Obviously: rõ ràng là
Promote: thăng tiến
Recognition: sự công nhận
Value: quý giá

Bargain: (v) mặc cả, trả giá; (n) món hời
Expand: mở rộng
Explore: khám phá
Mandatory: bắc buộc
Marked down: giảm giá

Diversify: mở rộng
Function: chức năng
Maintain: duy trì
Retain: giữ lại
Obtain: lấy được, có được
Prerequisite: điều kiện tiên quyết
Quality: chất lượng
source of this information: nguồn thông tin

Accurately: 1 cách chính xác
Fulfill: hoàn tất   fulfilled <-> request
Inventory: hàng tồn kho, sự kiểm kê hàng hóa
Sufficiently = enough: đủ
Supply (v) cung cấp, (n) hàng hóa

Invoices: hóa đơn ngành xuất nhập khẩu
Charge: (v) tính phí, (n) phí dịch vụ
Discount: giảm giá
Efficient: hiệu quả
Estimate: ước tính
Impose: áp dụng, áp đặt
Made mistake: làm lỗi
Order: đơn đặt hàng
Promptly: đúng giờ, 1 cách nhanh chóng
Terms: điều kiện, điều khoản, kỳ hạng

Adjustment: sự điều chỉnh
Disturb: quấy rầy
Interfere = interrupt: gián đoạn
Liability: trách nhiệm
Reflection: sự phản ánh
Verify: xác nhận

Accept: chấp nhận
Balance: số dư tài khoản
Dividend: cổ tức
Mortgage: thế chấp
Restricted: giới hạn
Signature: chữ ký
Transaction: sự giao dịch

Audit: kiểm toán
Budget: ngân sách
Client: khách hàng
Debt: món nợ
Outstanding: chưa thanh toán
Profiably: 1 cách sinh lời

Fund (n) quỹ, (v) hỗ trợ
Invest: đầu tư
Long-term: dài hạn

File: nộp
Fill out: điền vào
Give up: từ bỏ
Owe: nợ
Penalty: hình phạt
Spouse: vợ/chồng
Payment: việc thanh toán
Withhold: giữ lại
Paycheck: tiền lương

Project: dự án
Projected income: thu nhập được dự tính

Adjacent to = next to: kế bên
Opt: lựa chọn

Goal = objective: mục tiêu
Objective idea: ý kiến khách quan
Lengthy: lâu dài
Matter: vấn đề
Priority: sự ưu tiên
In progress: đang trong tiến trình
Waste: lãng phí

Brand: nhãn hiệu
Enhance: tăng cường
Inspect: kiểm tra, thanh tra
Take responsibility: chịu trách nhiệm

Under any circumstance: dưới bất kỳ hoàn cảnh nào
Due to: bởi vì
Fluctuatte: lên xuống
Get out of: ra khỏi
Indicator: dấu hiệu
Lease: cho thuê
Occupy: chiếm giữ
Option: sự lựa chọn
Subject to: phải chịu, phải chấp nhận

Arrive: đến
Familiar with: quen với
Guide: người hướng dẫn, sách hướng dẫn
Majority of: phần lớn
Rely on: dựa vào
Subjective: chủ quan

Complete (adj) (v): hoàn tất

Delivery: sự giao hàng
Impress: gây ấn tượng
Individual: cá nhân
Narrow: thu hẹp, nhỏ lại     narrows down
Pick up: đón, lấy
Settle: giải quyết

Coordinate: kết hợp
Ideally: 1 cách lý tưởng
Site: vị trí, địa điểm

Agent = representative: người đại diện
Announcement change: công bố
Board: lên tàu, lên máy bay
Delay: trì hoãn
Flight depart: khởi hành
Itinerary: lịch trình
Prohibit: ngăn cấm    prohibited from
Valid: giá trị

Deal with: giải quyết, xử lý
Expense: phí tổn
Prospective: tiềm năng
Substantially = significantly: 1 cách đáng kể

Comprehensive: bao quát, toàn diện
Entitle: được quyền
Offset: bù đắp
Operate: hoạt động
Relatively: tương đối

Confirm: xác nhận
Expect: kỳ vọng
Notify: báo tin
Reservation: đặt chỗ trước
Service: dịch vụ

Intend to: có khuynh hướng

Combine: kết  hợp
Description: sự mô tả
Influence: ảnh hưởng
Range: phạm vi
Release: tung ra
Separately: 1 cách tách biệt

Take action: hoạt động
Approach: đến gần
Element: nhân tố
Experience (v) trải nghiệm, (n) kinh nghiệm
Occur: xảy ra
Perform: hoạt động
Rehearse: diễn tập
Performance: sự biểu hiện

Available: có sẵn
Broaden: (v) mở rộng
Favor: ưu ái, thiên vị
Favorable market: thị trường thuận lợi
Unfavorable market: thị trường ko thuận lợi
Urge: thúc dục
Preference: sự thích hơn, sự ưu tiên

Collection: bộ sưu tập
Express: bày tỏ
Response to: phản hồi
Schedule: lịch trình

Assignment: nhiệm vụ được giao
Constantly = continually: liên tục
Impact: tác động
Investigate: điều tra
Subscribe: đặt mua
Subscribers: người đặt mua

Appoint (v): bổ nhiệm
Annally: hằng năm
Make an appointment: sắp xếp 1 cuộc hẹn
Diagnose: chuẩn đoán
Prevent: ngăn chặn   prevented <-> from
Record: hồ sơ
Serious: nghiệm trọng, nghiêm túc
Distraction: sự sao lãng
Evident: hiển nhiên, rõ ràng
Evidence: chứng cứ
Position: vị trí
Restore: khôi phục

Alternative: sự lựa chọn thay thế cái này cho cái khác
Aspect: khía cạnh
Concern: sự lo lắng (số nhiều)
Personnel: nhân sự
Policy: chính sách
Regardless of: bất chấp
Suit (v): phù hợp

Authorize: có thẩm quyền, ủy quyền
Designate: chỉ định, bố trí
Pertinent: thích hợp, tương ứng  (Vd: pertinent information)
Procedure: thúc dục

Consult: tham vấn, tư vấn
Control: điều khiển
Convenient: tiện lợi
Factor: nhân tố
Limit: giới hạn
Monitor: quản lý
Potential (adj) (n): tiềm năng
Sample: mẫu thử
Make sense: có nghĩa
Volunteer: tình nguyện

winter: mùa đông
spring: mùa xuân
summer: mua hè
fall: mùa thu


debt: nợ
interest rates: lãi suất
reputation: danh tiếng
racket: cái vợt
free of charge: miễn phí
reasonable price: giá hợp lý
get involved in: tham gia vào
favor: ân huệ
ex: could you do me a favor ?: bạn có thể cho tôi 1 ân huệ

Receipt: hóa đơn (đã thanh toán rồi)
Bill: hóa đơn (chưa thanh toán)
Refund: hoán tiền
Manufacturer: nhà sản xuất

In detail: chi tiết
Cartridge \kärtrij\: ống mực trong máy in 
Resumé: sơ yếu lí lịch
How often: bao lâu 1 lần
Since -> mốc thời gian
For -> khoảng thời gian

Analysis (n): bài phân tích
Analyst (n): nhà phân tích
Shipping : vận chuyển
Workshop: hội thảo / xưởng
Attendance is mandatory: sự tham dự thì bắt buộc
Lack of: thiếu

Can : có thể (100%)
Could: có thể (70%)
May: có thể (50%)
Might: có lẽ (20%)
life insurance: bảo hiểm nhân thọ
last: kéo dài
pick up: đón / đi lấy
faulty /'fɔ:lti/: tội lỗi
cruises /kru:z/: chuyến du ngoạn trên biển					 
more than = over: trên		
fabric /'fæbrik/: vải									
professional: (adj) chuyên nghiệp, (n) chuyên gia
for over fifteen years: trong hơn 15 năm
invent: phát minh
events: sự kiện
reward: tận hưởng
expertise /,ek spə' ti:z/: chuyên môn							
decade /'de kei d/: thập niên						
hardly = rarely: hiếm khi
color-blind: mù màu
no such thing as = nothing such as: không có gì như là

actor: diễn viên
occupation /,ɔ kju' pei ʃn/: nghề nghiệp
broadcaster /'brɔ:dkɑ:stə/: phát thanh viên
comedian /kə'mi:djən/: nhà hài kịch
donor /'dounə/: người hiến tặng

under any circumstances /'sə :kəm stəns/: dưới bất kỳ hoàn cảnh nào
until further notice /'noutis/: cho đến khi bất kỳ thông báo nào lần nữa
out of service = out of order: ngừng hoạt động
in service = in order: hoạt động bình thường
inventory /ˈinvənˌtôrē/: hàng tồn kho / sự kiểm kê hàng hóa
indicate that = show that

brochure /'brouʃjuə/: bài quãng cáo
interfere with  /,intə'fiə/: gián đoạn với
payment method: phương thức thanh toán
eligible /ˈeo li jơ bəl/: đủ tư cách, đủ điều kiện

as well as: theo như
guilty (adj) /ˈgil tē/: có tội
stay awake (adj)  /ə'weik/: thức tỉnh
decreased /'di:kri:s/: giảm
manufactured (v)  /,mænju'fæktʃə/:  sản xuất
serious /'siəriəs/: nghiêm trọng
meet /mi:t/: đáp ứng
nature /'neitʃə/: bản chất
pessimistic /,pesi'mistik/: bi quan

handicrafts: bi quan
opportunity /,ɔ pə' tju: niti/: cơ hội
inspired: truyền cảm hứng
create (v): tạo ra
creation: sản phẩm, sự tạo ra
clay: đất xét
pottery /'pɔtəri/: đồ gốm

result in: kết quả là
shoplifting: ăn cắp khi đi mua hàng
convicted of: buộc tội về

on sale: đc bán ở giá thấp hơn
for sale: để bán
ex: Many items will be on sale at reasonable prices these products are available for sale
buyers: những người mua có tâm

bail /beil/ /bāl/: phí bảo lãnh
necklace /'neklis/: vòng cổ
purse /pə:s/: bóp
scarf /skɑ:f/: khăn

whenever: bất cứ khi nào
tobe + adj
the reason why: lý do tại sao
particular /pə'tikjulə/: đặc biệt
indifferent: thờ ơ
dependent on  /di'pendənt/: phụ thuộc vào
independent on: không phụ thuộc vào
directed toward /di'rekt/ /tə'wɔ:d/: chỉ về, hướng tới
politicians /,pɔli'tiʃn/ : nhà chính trị
enclosed is a refund: được đính kèm là tiền hoàn trả
praise: /preiz/  khen ngợi
althought = despite the fact that = even thought = thought = mặc dù
from now on: kể từ bây giờ

because + mệnh đề : bởi vì
since + mệnh đề / + V_ing: bởi vì
endless: không chấm dứt, bất tận
advantage: lợi ích

disposable: sử dụng 1 lần,
loyal: trung thành
against: chống lại
a campaign against using disposable cups has begun: chiến dịch chống lại việc sử dụng cốc 1 lần
look after: chăm sóc
termination: sự chấm dứt
cost involved: chi phí có liên quan



convicted of: buộc tội về
fatal /'fei tl/: gây chết người								
line of products: dây chuyền sản xuất
subway /'sʌb wei/: tàu điện ngầm								
entire /in'tai ə/: toàn bộ									
depicts /di'pikt/: mô tả									
audience /'ɔ:djəns/: khán giả									
judges /'dʤʌdʤ/ /zớt zj/: ban giám khảo, quan tòa					
the map is yours to keep: bạn có thể giữ tấm bản đồ
issue /'I sju:/: ấn bản	, vấn đề								
wasteful /'weis t ful/: lãng phí									

care for: quan tâm
take a shower: đi tắm

Adopt: chấp nhận
Assign: chỉ định, nhiệm vụ được giao
Lend: cho mượn
Borrow: đi mượn
Raise: mức tăng lương
Rise: sự gia tăng
Require: yêu cầu
Proceed: (v) xúc tiến, 
Affect (v) – effect (n): ảnh hưởng
Prosecute: truy tố
Inflation: sự lạm phát

Aid (v, n): hỗ trợ
Aide (n): trợ lý
Capital: vốn
Compliment: lời khen ngợi
Personnel (số nhiều): nhân sự

For further information
So….that
Neither…..nor

By express mail: bằng thư tốc hành
Accept: chấp nhận
Except: ngoại trừ (exception -> ngoại lệ)
Strategy (n): chiến lược
Promoted:  thăng tiến
Promotion: sự thăng tiến
Disclose: tiết lộ
Over my head: quá sức tôi
Deduct: trừ ra

However = no matter how: cho dù thế nào
However + adj = no matter how + adj
Ought + to = should: nên
Be able to: có thể

Deposit :(v) gửi tiền, (n)tiền gửi
Interest rates: lãi suất
Mortgage: thế chấp
Transfer: chuyển tiền
Withdraw: rút tiền
Receipt: hóa đơn


Advertising: việc quãng cáo
Advertisement: bản/mẫu quãng cáo
Customer satisfaction: bộ phận chăm sóc khách hàng
Distribution: sự phân phối
Innocation: sự tân trang
Objectives: (n) mục tiêu
Purchase: mua
Tax revenue: danh thu thuế
Target market: thị trường mục tiêu
Make attempt  = make effort
Reflect: phản ánh
Focus on: chú trọng vào

Complimentary: miễn phí
Front desk: bàn trước, lễ tân
Premises: khuôn viên
Receptionist: nhân viên lễ tân
Reservation: đặt chỗ trước
Serve: phục vụ
Take an order: nhận đơn đặt hàng
Place an order: đặt hàng
Licensed: giấy phép

Executive: người điều hành
Seminar: hội thảo
Supervisor: người giám sát
Deadline: hạn chót
Feedback: phản hồi
Proposed: đề suất

Cleck: nhân viên bán hàng
Damaged: thiệt hại
Discount: giảm giá
Refund: hoàn tiền lại
Reputation: danh tiếng
Stock: (v) tích trữ, (n)hàng hóa
Dawn somebody’s attention: lôi kéo sự chú ý của ai
Shortages: thiếu hụt
Until futher notice: cho đến khi có bất kỳ thông báo nào nữa
Regular customer: khách hàng thường xuyên
Reasonable prices: giá hợp lý
Rival: (v), (n), (adj) đối thủ cạnh tranh cùng mặt hàng trong kdoanh

Congestion: sự tắc nghẽn
Delay (v, n): trì hoãn
Departure – depart(v): khởi hành
Passenger: hành khách
Transit: vận chuyển, quá cảnh
This is due to: đây là bởi vì
Restrict: giới hạn

Physician assistant: trợ lý bác sĩ nội khoa
Domestic: nội địa
Earpiece: tai nghe điện thoại
International: quốc tế

Economy: vé hạng phổ thông
Expense account: công tác phí
Package tour: du lịch trọn gói
Peak season: mùa du lịch cao điểm
Reservation: việc đặt chỗ trước
Reminder: sự nhắc nhở
Additional: thêm vào
Comfirm -> reservation
While in Madagascar: trong khi ở Madagascar
While in duty: trong khi làm nhiệm vụ
Thank for your exceptional contribution: cảm ơn sự đóng góp của bạn
Automatically: 1 cách tự động
Accordinglty: 1 cách tương ứng
Premium: phí bảo hiểm
Term: kỳ hạn
Terminate: chấm dứt
Covered: bảo hiểm

Annually: hằng năm
Budget: ngân sách
Conference: hội nghị
Consult: tham vấn
Itinerary: lịch trình
Presentation: bài thuyết trình
Quarterly: hàng quý
The rear the room: phía sau căn phòng

On behalf of: đại diện
On my behalf: đại diện tôi
On her behalf: đại diện cô ta
On his behalf: đại diện anh ta
Following: sau đây
Charged to our account: tính vào tài khoản của chúng tôi
